11111111111111111
111000000010001E1
111000C0001010101
1P100000C01010101
10100000001010101
100000C0000010001
11111111111111111
