11111111111111111
11100P000011001E1
10100000001010101
10100000001010101
10100000001010101
10000000000010001
11111111111111111
