1111111111111111111111
10000P0000000000000001
100000000C000000000001
1000000000000000000001
1000000E00000000000001
1000000000000000000001
1111111111111111111111
