11111111111111111
10000P00001C001E1
10000000001010101
10000000001010101
1000000C001010101
10000000000010001
11111111111111111
