1111111111111111
10000P0000000001
1000000000000001
100000000C000001
1000000000000001
1000000E00000001
1111111111111111
