111111111111111111111111111111
1P1000000000000000000000000001
101000000000000000000000000001
101000000000000000000000000001
111111111111111111111111111110