111111111111111
100000000000001
101000001000001
1P0000C000010E1
100000000000C01
111111111111111