1111111111111111
100P0000000E0001
10C0000000000001
100000000C000001
1000000000000001
100C00000C000001
1111111111111111
