1111
1E01
1C01
1001
1P01
1111
