1111111
100P001
10C0001
10E0001
1000001
1000001
1111111
